{
	"width" : 11,
	"height" : 10,
	"tileset" : "tiles.png",
	"terrain" : [
		[1, 1, 1, 1, 1, 1, 1, 1, 8, 8,  1,  1,  1,  1,  4],
		[1, 1, 1, 1, 1, 1, 1, 8, 2, 2,  8,  8,  1,  1,  3],
		[8, 8, 8, 8, 8, 8, 8, 2, 2, 2,  2,  2,  8,  8,  8],
		[2, 2, 2, 2, 2, 2, 2, 2, 2, 2,  2,  2,  2,  2,  2],
		[2, 2, 2, 2, 2, 2, 2, 2, 2, 2,  2,  2,  2,  2,  2]
	]
}
