{
	"tile_size" : 70,
    "tile_col" : 15,
    "tile_line" : 10, 
	"tileset" : "tiles_2.png",
	"terrain" : [
		[1, 14, 1, 1, 1, 1, 1, 1, 1, 1,  1,  1,  1,  1,  1,1,1,1,1,1,1,1,1,1,1,1,1,1,1,1,1,1,1,1,1,1,1,1,1,1],
		[1, 0, 0, 0, 0, 0, 0, 0, 0, 0,  0,  0,  0,  0,  0,0,0,0,0,0,0,0,0,0,1,0,0,0,0,0,0,0,0,0,0,0,0,0,0,1],
		[1, 0, 0, 0, 0, 0, 0, 0, 0, 0,  0,  0,  0,  0,  0,0,0,0,0,0,0,0,0,0,1,0,0,0,0,0,0,0,0,0,0,0,0,0,0,1],
		[1, 0, 0, 0, 0, 0, 0, 0, 0, 0,  0,  0,  0,  0,  0,0,0,0,0,0,0,0,0,0,1,0,0,0,0,0,0,0,0,0,0,0,0,0,0,1],
		[1, 0, 0, 0, 0, 0, 0, 0, 0, 0,  0,  0,  0,  0,  0,0,0,0,0,0,0,0,0,0,1,0,0,0,0,0,0,0,0,0,0,0,0,0,0,1],
		[1, 0, 0, 0, 0, 0, 0, 0, 0, 0,  0,  0,  0,  0,  0,0,0,0,0,0,0,0,0,0,0,0,0,0,0,0,8,8,0,0,0,0,0,0,0,1],
		[4, 0, 0, 0, 0, 0, 0, 0, 0, 0,  0,  0,  0,  0,  0,0,0,0,0,0,0,0,0,0,0,0,0,0,0,8,2,2,0,0,0,0,0,0,0,1],
		[3, 0, 0, 0, 0, 0, 0, 0, 0, 0,  0,  0,  0,  0,  0,0,0,0,0,0,7,7,7,0,0,0,0,0,8,2,2,2,0,0,0,0,0,0,0,1],
		[3, 4, 0, 0, 0, 0, 0, 0, 0, 0,  0,  0,  0,  0,  0,0,0,0,0,0,0,0,0,0,0,0,0,8,2,2,2,2,0,0,0,0,0,0,0,1],
		[3, 3, 4, 8, 8, 8, 7, 10, 10, 10,  10,  7,  8,  8,  8,0,0,0,0,0,0,0,0,0,0,0,8,2,2,2,2,2,0,0,0,0,0,0,0,1],
		[3, 3, 3, 2, 2, 2, 6, 6, 6, 6,  6,  6,  2,  2,  2, 8,8,8,20,20,20,20,8,8,8,8,2,2,2,2,2,2,8,8,8,8,8,8,8,9],
		[8, 8, 8, 2, 2, 2, 2, 2, 2, 2,  2,  2,  2,  2,  2, 2,2,2,2,2,2,2,2,2,2,2,2,2,2,2,2,2,2,2,2,2,2,2,2,2],
		[2, 2, 2, 2, 2, 2, 2, 2, 2, 2,  2,  2,  2,  2,  2,2,2,2,9,9,9,9,9,9,9,9,9,9,9,9,9,9,9,9,9,9,9,9,2,2]
	]
}
