{
	"width" : 10,
	"height" : 10,
	"tileset" : "chemin.png",
	"terrain" : [
		[10, 10, 2, 2, 2, 2, 9, 10, 11,  2,  2,  2,  2,  2,  2],
		[2, 2, 2, 2, 2, 2, 9, 10, 11,  2,  2,  2,  2,  2,  2],
		[2, 2, 2, 2, 2, 2, 9, 10, 11,  2,  2,  2,  2,  2,  2],
		[2, 2, 2, 2, 2, 2, 9, 10, 11,  2,  2,  2,  2,  2,  2],
		[2, 2, 2, 2, 2, 2, 9, 10, 11,  2,  2,  2,  2,  2,  2],
		[2, 2, 2, 2, 2, 2, 9, 10, 11,  2,  2,  2,  2,  2,  2],
		[2, 2, 2, 2, 2, 2, 9, 10,  8,  6,  6,  6,  6,  6,  6],
		[2, 2, 2, 2, 2, 2, 9, 10, 10, 10, 10, 10, 10, 10, 10],
		[2, 2, 2, 2, 2, 2, 9, 10, 12, 14, 14, 14, 14, 14, 14],
		[2, 2, 2, 2, 2, 2, 9, 10, 11,  2,  2,  2,  2,  2,  2],
		[2, 2, 2, 2, 2, 2, 9, 10, 11,  2,  2,  2,  2,  2,  2],
		[2, 2, 2, 2, 2, 2, 9, 10, 11,  2,  2,  2,  2,  2,  2],
		[2, 2, 2, 2, 2, 2, 9, 10, 11,  2,  2,  2,  2,  2,  2],
		[2, 2, 2, 2, 2, 2, 9, 10, 11,  2,  2,  2,  2,  2,  2],
		[2, 2, 2, 2, 2, 2, 9, 10, 11,  2,  2,  2,  2,  2,  2]
	]
}
